1111111
1P00001
1C00001
10000E1
1000001
1111111
1111111