11111111111111111111111111
1P000000000000000000000001
10000000001111110000000001
1000CCCCCCCCCCCCCCCCCCC001
110C1111111111111111111C11
1110C1111111111111111111C1
1000CCCCCCCCCCCCCCCCCCC001
10000000001111110000000011
10000000000000000000000001
100000000000000000000000E
11111111111111111111111111