1111111111111111111111111111
1000E000000000P0000000000111
1000000000000C00000000000001
1000001000000000101111111011
1000000000000000000000000001
1000000000000000000000000001
111111111111111111CCCCC10111
1000000000000000000000000001
1000000000000000111111111111
1111111111111111111111111111
1111111111111111111111111111