111111111111111111111111111111
1PC0010C10C1010C10C1110C101001
10C0010C10C1010C10C1110C101001
10C0010C00C1010C10C1110C101001
10C1000C10C0000C00C0000C001001
10C0010C10C1010C10C1010C101001
10C1010C10C1010C10C1110C101E01
10C0010C10C1010C10C1110C101001
10C1010C10C1010C10C1110C101001
111111111111111111111111111111